0, 0, 0, 3, 0, 3, 0, 3
1, 1, 2, 3, 2, 3, 2, 3
1, 0, 0, 1, 0, 1, 0, 1
2, 0, 4, 5, 6, 7, 4, 5
3, 0, 8, 9, 14, 15, 8, 9