0, 0, 0, 3, 0, 3, 0, 3
1, 1, 2, 3, 2, 3, 2, 3
1, 0, 0, 1, 0, 1, 0, 1
2, 0, 4, 5, 6, 7, 4, 5
3, 0, 18, 19, 30, 31, 18, 19